K	Kilo- (metric 1000)
K9	canine (K9 corps - army dogs)
KAIST	Korean Advanced Institute of Science and Technology
KAO	Kuiper Airborne Observatory [Space]
KB	KiloByte
KC	King's Counsel (QC when queen reigning)
KC	Knights of Columbus
KD	Kiln Dried
KD	Knocked Down
KDCI	Key Display Call Indicator
KERMIT	Kl-10 Error-free Reciprocal Micro Interconnect over Tty lines
KET	Kentucky Educational Television
KHz	Kilo HertZ (unit of frequency, 1000 cycles per second)
KI	Kiwanis International
KIA	Killed In Action
KIAS	Knot Indicated Air Speed
Km	Kilometers
KO	Knock Out [Boxing, Electric]
KP	Key Pulse [Telephony]
KP	Kitchen Police
KPNO	Kitt Peak National Observatory
KPO	KeyPunch Operator
KQC	King's College London
K&R	Kernighan and Ritchie, the c programming language
KS	King's Scholar
KSC	Kennedy Space Center (NASA) [Space]
KSU	Key System Unit [Telephony]
KTB	Cretaceous-Tertiary Boundary (from German) [Space]
KTS	Key Telephone System [Telephony]
KTU	Key Telephone Unit [Telephony]
KWIC	Key Word In Context
KY	Kentucky
L1	Lagrange Point #1 35,000 Miles above moon [Space]
L2	Lagrange Point #2 40,000 Miles behind moon [Space]
L3	Lagrange Point #3 (?? 35,000 Miles below moon) [Space]
L4	Lagrange Point #4 240,000 mile Earth orbit [Space]
L5	Lagrange Point #5 240,000 mile Earth orbit [Space]
LA	Los Angeles
LA	Louisiana
LA	Low Altitude
LADAR	LAser Detection And Ranging
LAM	Master of Liberal Arts
LAMA	Local Automatic Message Accounting [Telephony]
LAN	Local Apparent Noon
LAN	Local Area Network
LANL	Los Alamos National Laboratory [Space]
LANL	Los Alamos (NM) National Laboratory
LAPB	Link Access Procedure (Balanced)
LAPD	Link Access Procedure (??)
LAPD	Los Angeles (CA, US) Police Department
LAR	Local Acquisition Radar
LaRC	Langley Research Center (NASA) [Space]
LASER	Light Amplification by Stimulated Emission of Radiation
LAT	Local Apparent Time
LATA	Local Access and Transport Area [Telephony]
LAX	Los Angeles International Airport
LB	Light Bomber
LB	pound (LiBra)
LBHS	Long Beach High School
LBL	Lawrence Berkeley (Calif.) Labs
LBS	Pounds
LC	inductor-Capacitor circuit (as in filters, L is symbol inductance)
LCD	Liquid Crystal Display
LCD	Lowest Common Denominator
LCDR	Lieutenant Commander
LCL	Less than Carload Lot [Railroading]
LCL	Lunar Cargo Lander [NASA OEXP]
LCM	Least Common Multiple
LCM	Life Cycle Management
LCS	Laboratory for Computer Science (of MIT)
LCT	Landing Craft Tanks
LD	Long Distance [Telephony]
LDC	Long Distance Carrier [Telephony]
LDEF	Long Duration Exposure Facility [Space, NASA]
LDF	Large Deployable Reflector [Space]
LDL	Low Density Lipoprotein
LDX	Long Distance eXtender [Telephony]
LEAP	Low-power Enhanced At Portable
LEC	Local Exchange Carrier [Telephony]
LED	Light Emitting Diode
LEM	Lunar Excursion Module (a.k.a. LM) (Apollo spacecraft) [Space]
LEO	Low Earth Orbit [Space]
LEP	Large Electron-Positron collider [CERN]
LeRC	Lewis Research Center (NASA) [Space]
LEST	Large Earth-based Solar Telescope [Space]
LF	Low Frequency (30-300KHz)
LFSA	List of Frequently Seen Acronyms (!) [Space]
LGA	Low Gain Antenna [Space]
LGM	Little Green Men [Space]
LH	Left Hand
LH	Liquid Hydrogen (also LH2 or LHX) [Space]
LH	Lower Half
LH	Luteinizing Hormone (same as ISCH)
LHC	Large Hadron Collider [CERN]
LHD	Litterarum Humaniorum Doctor (doctor of human letters)
LHS	Left Hand Side
LI	Long Island
LIFIA	Laboratoire d'Informatique Fondamentale et d'Intelligence Artificielle
LIFO	Last In First Out (see FIFO)
LINC	Laboratory INstrument Computer
LISA	Large Installation Systems Administration (USENIX specific?)
LISP	LISt Processing Language
LIU	Line Interface Unit
LL	Late Latin
LL	Long Lines [Telephony]
LLB	Legum Baccalaureus (bachelor of laws)
LLD	Legum doctor (doctor of laws)
LLN	Line Link Network [Telephony]
LLNL	Lawrence Livermore National Laboratories
LLO	Low Lunar Orbit [Space]
LLOX	Lunar Liquid Oxygen [Space]
LLP	Line Link Pulsing [Telephony]
LM	Life Master (Contract Bridge ranking)
LM	Lunar Module (a.k.a. LEM) (Apollo spacecraft) [Space]
LMC	Large Magellanic Cloud (see SMC)
LMC	Large Magellanic Cloud [Space]
LMOS	Line Maintenance Operations System [Telephony, AT&T]
LN2	Liquid N2 (Nitrogen) [Space]
LNG	Liquified Natural Gas
LOA	Lands of Adventure
LOFT	Launch Operations Flight Test [Space]
LOOPS	Lisp Object Oriented Programming System
LOP	Lines Of Position
LOSF	Lunar Orbit Staging Facility [Space]
LOTS	Low Overhead Timesharing System
LOX	Liquid Oxygen
LOX	Liquid OXygen [Space]
LP	Long Play(ing) (record)
LP	Low Pressure
LPC	Linear Predictive Coding (speech processing)
LPDA	Link Problem Determination Aid
LPF	League for Programming Freedom
LPG	Liquefied Petroleum Gas
LPG	Low Pressure Gas
LPL	Lunar Personnel Lander [NASA OEXP]
LPN	Licensed Practical Nurse
LPP	Licensed Program Products
LPR	Line PrinteR
LPT	Lunar Propellant Tanker [NASA OEXP]
LPV	Lunar Piloted Vehicle [NASA OEXP]
LRB	Liquid Rocket Booster [Space]
LRBM	Long Range Ballistic Missile
LRC	Longitudinal Redundancy Character
LRU	Least Recently Used
LRU	Line Replaceable Unit
LRV	Light Rail Vehicle [Railroading]
LS	Left Side
LS	Letter Signed
LS	Locus Sigilli (place of seal)
LSAP	Logical(?, maybe Link) Service Access Point [OSI, Networking]
LSB	Least Significant Bit; Least Significant Byte
LSB	Lower Side Band
LSC	Lecture Series Committee (of MIT)
LSC	LightSpeed C
LSD	Least Significant Digit
LSD	LySergic acid Diethylamide
LSD	pounds (Libra), shillings (Sestertii), and (old) pence (Denarii)
LSI	Large Scale Integration
LSP	LightSpeed Pascal
LSR	Local Standard of Rest [Space]
LSS	Life Support System
LSS	Loop Switching System
LSSD	Level-Sensitive Scan Detection
LT	Long Ton
LT	Low Tension
LTC	Lieutenant Colonel
LTJG	Lieutenant Junior Grade
LTL	Less than Truckload Lot
LTP	Lunar Transient Phenomenon [Space]
LUG	Local Users Group
LUT	Look-Up Table
LWM	Low-Water Mark
LWT	London Weekend Television [Corporate name]
LZ	Landing Zone
M	Mega- (metric 10^6)
m	meter(s)
m	milli- (metric 1/1000)
M	Miniatures
MA	Massachusetts [US state postal designation]
MAAP	Maintenance And Administration Panel
MAC	an MIT interdepartmental lab (stands for many things) (renamed to LCS)
MAC	Media Access Control
MAC	Medium Access Control
MAC	Military Air Command
MACSYMA project MAC's SYmbolic MAnipulation System
MAD	Mutual Assured Destruction
MADD	Mothers Against Drunk Driving
MAG	Magazine
MAN	Metropolitan Area Network
MAP	Manufacturing Automation Protocol
MAP/TOP Manufacturing Automation Protocol/Technical Office Protocol
MARBI	MAchine Readable form of Bibliographic Information
MARC	MAchine Readable card Catalog
MARS	Multiuser Archival and Retrieval System
MASC	Multiple Award Schedule Contract
MASER	Microwave Amplification by Stimulated Emission of Radiation
MASH	Mobile Army Surgical Hospital
MAST	Multi-Application SOnar Trainer
MAT-CALS	Marine Air Traffic-Control And Landing System
MAU	Math Acceleration Unit
MAU	Media Access Unit
MAU	Medium Access Unit
MB	Manned Base [Space]
MB	MegaByte
MBA	Master Business Administration
MBTA	Massachusetts Bay Transportation Authority
MC	Master of Ceremonies
MCA	Micro Channel Architecture
MCAE	Mechanical Computer Aided Engineering
MCC	Master Control Console
MCC	Microelectronics and Computer technology Corporation
MCC	Mission Control Center [Space]
MCP	Master Control Program
MCP/AS	Master Control Program/Advanced System
MCPO	Master Chief Petty Officer
MCSV	Mars Crew Sortie Vehicle [NASA OEXP]
MD	Doctor of Medicine
MD	Maryland
MD	Maryland [US state postal designation]
MD	Medical Doctor
MD	Months after Date
MDAS	Magnetic Drum Auxiliary Sender
MDC	Metropolitan District Commision (Mass State Agency)
MDE	Modular Design Environment
MDF	Main Distribution Frame [Telephony]
MDRE	Mass Driver Reaction Engine [Space]
MDT	Mean Down Time
ME	Maine
ME	Mechanical Engineer
MECO	Main Engine CutOff [Space, Shuttle]
MEd	Master of EDucation
MERP	Middle-Earth Role Playing
MeV	Million Electron Volts
MF	Medium Frequency (300-3000KHz)
MF	Middle French
MF	Multi-Frequency [Telephony]
MFA	Master Fine Arts
MFA	Museum of Fine Arts [Boston]
MFJ	Modified Final Judgment [Telephony]
MFLOPS	Million FLoating-point OPerations per Second (see also FLOPS)
MFM	Modified Frequency Modulation
MFS	Macintosh File System
MG	Machine Gun
MG	Major General
MG	Military Government
MGH	Massachusetts General Hospital
MGM	Metro-Goldwyn Mayer [Corporate name]
MHD	MagnetoHydroDynamics
MHS	Mail Handling System [ISO]
MHz	Mega HertZ (unit of frequency, 1,000,000 cycles per second)
MI	Michigan
MI	Military Intelligence
MIA	Missing In Action
MIB	Management Information Base
MIDI	Musical Instrument Digital Interface
MIFASS	Marine Integrated Fire And Support System
MILNET	MILitary NETwork
MIM	Morality In Media
MIMD	Multiple Instruction, Multiple Data
MINCE	MINCE Is Not Complete Emacs
MINE	MINE Is Not Emacs (but it is mine)
MIPS	Million Instructions Per Second
Mir	Peace [Russian]
MIRV	Multiple Independently-Targetable Reentry Vehicle
MIS	Management Information System
MIT	Massachusetts Institute of Technology
ML	Middle Latin
mL	milliliter(s)
MLA	Member of Legislative Assembly (see MPP)
MLD	Minimum Lethal Dose
MLL	Mars Logistics Lander [NASA OEXP]
MLS	Microwave Landing System
MLS	Multi-Level Security
MLV	Medium Lift Vehicle [NASA OEXP]
MM	Maryknoll Missioners
mm	millimeters
MMES	Martin Marietta Energy Systems
MMFS	Manufacturing Message Format Standard
MMH	MonoMethyl Hydrazine [Space]
MMM	see 3M
MMT	Multiple Mirror Telescope [Space]
MMU	Manned Maneuvering Unit [Space]
MMU	Memory Management Unit
MMW	Multi-Mega Watt [Space]
MN	Minnesota
MNA	Member of National Assembly (Quebec)
MNP	Microcom Networking Protocol [Corporate name]
MNRAS	Monthly Notices of the Royal Astronomical Society [Space]
MO	Mail Order
MO	Medical Officer
MO	Missouri
MO	Modus Operandi
MO	Money Order
MOC	Mars Observer Camera (on Mars Observer) [Space]
MOD	Ministry of Defence (UK) (sometimes written MoD)
MOL	Manned Orbiting Laboratory [Space]
MOLA	Mars Observer Laser Altimeter (on Mars Observer) [Space]
MOMA	Museum of Modern Art [New York]
MOMV	Manned Orbital Maneuvering Vehicle [Space]
MOR	Middle-Of-the-Road
MOS	Metal Oxide Semiconductor
MOSFET	Metal Oxide Semiconductor Field Effect Transistor
MOTAS	Member Of The Appropriate Sex
MOTIS	Member Of The Inappropriate Sex
MOTIS	Message-Oriented Text Interchange System
MOTOS	Member of the Opposite Sex
MOTSS	Member of the Same Sex
MOTV	Manned Orbital Transfer Vehicle [Space]
MOU	Memorandum Of Understanding
MOUSE	Minimum Orbital Unmanned Satellite of Earth
MP	Melting Point
MP	Member of Parliament
MP	Metropolitan Police
MP	Military Police(man)
MPC	Minor Planets Circular [Space]
MPE	Mission to Planet Earth [Space]
MPG	Miles Per Gallon
MPH	Miles Per Hour
MPP	Member of Provincial Parliament (Canada; also MLA)
MPR	Mars Pressurized Rover [Space]
MPV	Mars Piloted Vehicle [NASA OEXP]
MPW	Macintosh Programmer's Workshop
MR	Miniatures Rules
MRI	Magnetic Resonance Imaging
MRP	Manufacturing Requirements Planning
MRSR	Mars Rover and Sample Return [Space]
MRSRM	Mars Rover and Sample Return Mission [Space]
MS	ManuScript
MS	Master of Science
MS	Military Science
MS	Motor Ship
MS	Multiple Sclerosis
MSB	Most Significant Bit; Most Significant Byte
MSC	MicroSoft C
MSCP	Mass Storage Control Protocol
MSD	Most Significant Digit
MS-DOS	MicroSoft DOS
MSE	Mobile Subscriber Equipment
MSFC	(George C.) Marshall Space Flight Center (NASA) [Space]
MSFC	Marshall Space Flight Center
MSG	MonoSodium Glutamate
MSH	Marvel Super Heroes
MSL	Mean Sea Level
MSPCA	Massachussetts Society for the Prevention of Cruelty to Animals
MSPE	Mercenaries, Spies & Private Eyes
MSRP	Manufacturer's Suggested Retail Price
MSS	Management Support System
MSS	ManuScriptS
MSS	Mass Storage System
MSS	Maximum Segment Size [TCP/IP] (see also MTU)
MST	Mountain Standard Time
MT	Metric Ton
MT	Mountain Time
MTA	Message Transfer Agent
MTA	Metropolitan Transportation Authority
MTBF	Mean Time Between Failures
MTC	Man Tended Capability [Space]
MTR	Magnetic Tape Recording
MTSO	Mobile Telephone Switching Office [Telephony]
MTTF	Mean Time To Failure
MTTR	Mean Time To Recovery
MTTR	Mean Time To Repair
MTU	Maximum Transfer Unit [Networking] (see also MSS)
MTV	Music TeleVision
MUF	Maximum Usable Frequency (max freq during sunspot activity)
MULTICS MULTiplex Information Computer Services
MUMPS	Mgh Utility MultiProgram System
MUNG	Mung Until No Good (see the hacker's dictionary)
MUX	MUltipleXor
MVA	MegaVolt Ampere
MVS	Multiple Virtual Storage [IBM]
MX	Missile eXperimental
N	North
N	Notice
NA	Narcotics Anonymous
NA	North America
NA	Not Applicable
NAACP	National Association for the Advancement of Colored People
NAAS	North American Automated Systems co.
NAB	National Association of Broadcasters
NABISCO NAtional BIScuit COmpany [Corporate name]
NACCIRN North American Coordinating Committee for Intercontinental Research Networking (see also CCIRN)
NACS	National Advisory Committee on Semiconductors
NAD	Network Access Device
NADGE	NATO Air Defense Ground Environment
NAG	Numerical Algorithms Group
NAGE	National Association of Government Employees
NAK	Negative AcKnowledge
NAM	Name and Address Module [Telephony] (cellular phone changeable ROM)
NAM	National Account Manager [Telephony, AT&T]
NAM	Number Assignment Module [Telephony] (cellular phone changeable ROM)
NANP	North American Numbering Plan
NAPAP	National Acid Precipitation Assessment Program
NAR	Nuclear Acoustic Resonance
NARDAC	NAvy Regional Data Automation Center
NAS	National Academy of Sciences
NAS	National Advanced Systems
NASA	National (US) Aeronautics and Space Administration [Space]
NASDA	NAtional (Japan) Space Development Agency [Space]
NASM	National (US) Air and Space Museum [Space]
NASP	National (US) AeroSpace Plane [Space]
NATO	North Atlantic Treaty Organization
NAVDAC	NAVal Data Automation Command
NAVSWC	NAVal Surface Weapons Center
NB	New Brunswick
NB	Nota Bene
NBA	National (US) Basketball Association
NBC	National (US) Broadcasting Company [Corporate name]
NBFM	NarrowBand Frequency Modulation
NBO	Network Build Out
NBS	National Bureau of Standards (renamed NIST) [US Government]
NBVM	Narrow Band Voice Modulation
NC	No Charge
NC	No Connection
NC	North Carolina
NCA	Network Control Analysis
NCC	National (US) Computer Conference
NCC	National (US) Council of Churches
NCDC	National (US) Climatic Data Center
NCE	New Catholic Edition
NCGA	National (US) Computer Graphics Association
NCI	National (US) Cancer Institute [US Government]
NCIC	National (US) Cartographic Information Center
NCO	Non-Commissioned Officer
NCP	Network Control Program
NCR	National (US?) Cash Register [Corporate name]
NCS	Network Computing System
NCSA	National (US) Center for Supercomputing Applications
NCSC	National (US) Computer Security Center [NSA]
NCTL	National Computer and Telecommunications Laboratory
NCV	No Commercial Value
ND	No Date
ND	North Dakota
NDA	Non-Disclosure Agreement
NDDL	Neutral Data Definition Language
NDE	News Development Environment
NDEA	National (US) Defense Education Act
NDL	Network Database Language
NDP	New Democratic Party (Canada)
NDSL	National (US) Defense Student Loan
NDSL	National (US) Direct Student Loan
NDT	Newfoundland Daylight Time
NDV	NASP Derived Vehicle
NDV	NASP Derived Vehicle [Space]
NE	New England
NE	North East
NEAR	National Electronic Accounting and Reporting system
NEARnet New England Academic and Research Network
NEB	New English Bible
NEC	Nippon Electric Company [Corporate name]
NEI	Not Elsewhere Included
NES	National Energy Strategy
NES	Not Elsewhere Specified
NESC	National Energy Software Center
NET	National (US) Educational Television
NET	NETwork
NET	New England Telephone
NEWS	Network extensible Window System
NEXRAD	NEXt generation weather RADar
NF	No Funds
NFC	National (US) Football Conference
NFFE	National (US) Federation of Federal Employees
NFL	National (US) Football League
NFS	Network File System
NG	National Guard
NG	No Good
NGC	New General Catalog [Space]
NH	New Hampshire
NHI	National Health Insurance
NHL	National (Canada) Hockey League
NHLBI	National Heart, Lung, and Blood Institute (Bethesda, MD)
NIC	Network Information Center ("The NIC" is NIC.DDN.MIL)
NICMOS	Near Infrared Camera / Multi Object Spectrometer (HST upgrade) [Space]
NIFTP	(a file transfer network in the UK)
NIH	National (US) Institutes of Health
NIH	Not Invented Here
NIM	Nuclear Instrumentation Module (an electronic instr. standard)
NIMH	National Institute of Mental Health (Rockville, MD)
NIMS	Near-Infrared Mapping Spectrometer (on Galileo) [Space]
NIR	Near InfraRed [Space]
NIS	Network Information System (formerly yp)
NISO	National Information Standards Organization
NIST	National Institute of Standards and Technology (formerly NBS) [US Government]
NJ	New Jersey
NJB	New Jersey Bell [Telephony]
NL	National League (baseball)
NLM	National Library of Medicine
NLP	Natural Language Processing
NLRB	National Labor Relations Board
NLS	Network License Server
NM	Nautical Mile
NM	New Mexico
NM	Night Message
NM	No Mark; Not Marked
NMOS	N channel Metal Oxide Semiconductor (N-MOS) (see MOS)
NMR	Nuclear Magnetic Resonance
NMS	Network Monitoring Station
NNE	North North East
NNTP	Net News Transfer Protocol
NNW	North North West
NNX	NANP syntax for a three-digit string, N:{2-9}, X:{0-9} [Telephony]
NOA	NSWC Office Automation
NOAA	National Oceanic and Atmospheric Administration [Space, US Government]
NOAO	National (Tucson, AZ, US) Optical Astronomical Observatories [Space]
NOC	Network Operations Center
NORAD	NORth American Defense Command
NORM	Naturally Occuring Radioactive Material
NORML	National Organization for the Reform of Marijuana Laws
NOS	Not Otherwise Specified
NOSC	Naval Ocean Systems Center
NOTIS	Network Operator Trouble Information System
NOW	Negotiable Order for Withdrawal [Banking] (Is this MA or NE specific?)
NOx	Nitrogen Oxides
NP	No Protest
NP	Nondeterministic-Polynomial
NP	Notary Public
NP	Noun Phrase
NPA	Numbering Plan Area (area code) [Telephony]
NPC	Non-Player Character (see PC) [Role-playing]
NPL	National Physical Laboratory (UK)
NPL	Non-Procedural Language
NPN	Negative-Positive-Negative (transistor)
NPN	NonProtein Nitrogen
NPR	National Public Radio
NPR	non-Processor Request [PDP11, UNIBUS]
NQS	Network Queuing System
NRA	National Reconstruction Act (FDR era US)
NRA	National Rifle Association
NRAO	National Radio Astronomical Observatory [Space]
NRC	National Research Council
NRC	Nuclear Regulatory Commission
NRE	Non-Recurring Engineering (as in NRE costs)
NREN	National (US) Research and Education Network
NRL	Naval Research Labs
NRO	National Reconnaissance Office
NRO	National Reconnaissance Organization [Space]
NRZ	Non-Return to Zero
NRZI	Non-Return to Zero Inverted (magnetic tape, 800 bpi)
NS	Neutron Star [Space]
NS	Not Specified
NS	Nova Scotia
NS	Nuclear Ship
NSA	National Security Agency [US Government]
NSAP	Network Service Access Point [OSI, Networking]
NSC	National (US) Security Council [US Government]
NSE	Network Software Environment
NSF	National (US) Science Foundation [US Government]
NSS	Nodal Switching System [NSFnet]
NSSDC	National Space Science Data Center [Space]
NST	Newfoundland Standard Time
NSTS	National Space Transportation System [Space]
NSW	New South Wales (Australia)
NSWC	Naval Surface Warfare Center
NSWC	Naval Surface Weapons Center
NT	New Testament
NT	Newfoundland Time
NT	Northern Territory
NTEU	National Treasury Employees Union
NTIS	National Technical Information Service
NTN	Neutralized Twisted Nematic
NTP	Network Time Protocol [Internet]
NTP	Normal Temperature and Pressure (see STP)
NTSB	National Transportation Safety Board [US Government]
NTSC	National Television Standards Committee
NTSC	Never Twice Same Color
NTT	New Technology Telescope [Space]
NTT	Nippon Telephone & Telegraph
NU	Name Unknown
NURBS	NonUniform Rational B-Spline
NUSC	Naval Underwater Systems Center [US Government]
NV	Nevada
NW	North West
NWNET	NorthWestNet
NWS	National Weather Service
NWT	North West Territories (Australia)
NXX	NANP syntax for a three-digit string, N:{2-9}, X:{0-9} [Telephony]
NY	New York
NYC	New York City
NYNEX	New York and New England (Telephone)
NYPD	New York Police Department
NYSE	New York Stock Exchange
NYSERNet	New York State Educational and Research Network
NZ	New Zealand
NZUSUGI New Zealand Unix System User Group, Inc.
OA	Office Automation
OA	Overeaters Anonymous
OAO	Orbiting Astronomical Observatory [Space]
OAS	Organization of American States
OATS	Office Automation Technology and Services
OBE	Order of the British Empire
OBS	Omni Bearing Selector
OC	Order of Canada
OCDM	Office of Civil Defense and Mobilization
OCI	Out of City Indicator
OCLC	Online Computer Library Center, Inc.
OCLC	Online Computer Library Center (Ohio College Library Catalog)
OCO	Object Code Only
OCR	Optical Character Recognition
OCS	Officer Candidate School
OCST	Office of Commercial Space Transportation [Space]
OD	Doctor of Optometry
OD	Oculus Dexter (right eye)
OD	Officer of the Day
OD	OverDose
ODI	Optical Digital Image
ODISS	Optical Digital Image Storage System
ODT	Octal Debugging Technique
ODT	Online Debugging Technique
OE	Old English
OED	Oxford English Dictionary
OEM	Original Equipment Manufacturer
OEO	Office of Economic Opportunity
OES	Order of the Eastern Star
OEXP	Office of Exploration [NASA]
OF	Old French
OFM	Order of Friars Minor
OFS	Order of Free State
OG	Original Gum
OH	Ohio
OIRA	Office of Information and Regulatory Affairs
OIU	Office Interface Unit
OJT	On the Job Training
OLTP	On-Line Transaction Processing
OMB	Office of Management and Budget [US Government]
OMD	Orchestral Manouevers in the Dark
OMS	Orbital Maneuvering System [Space]
OMV	Orbital Maneuvering Vehicle [Space]
ON	Old Norse
ONC	Open Network Computing
ONI	Office of Naval Intelligence
ONI	Operator Number Identification [Telephony]
ONR	Office of Naval Research
OOP	Object Oriented Programming
OOPART	Out Of Place ARTifact
OOPS	Object-Oriented Programming System
OP	Observation Post
OP	OFFICEPOWER office automation system, trademark of CCI
OP	Order of Preachers
OP	Out of Print
OPEC	Organization of Petroleum Exporting Countries
OPF	Orbiter Processing Facility [Space]
OPM	Office of Personnel Management
OPUS	Obvious Password Utility System (Eugene Spafford <Spaf@Purdue.Edu>)
OR	Operating Room
OR	Oregon
OR	Owner's Risk, Own Risk
ORFEUS	Orbiting and Retrievable Far and Extreme Ultraviolet Spectrometer [Space]
ORNL	Oak Ridge National Laboratory
OROM	Optical Read Only Memory
OS	Oculus Sinister (left eye)
OS	Operating System
OS	Ordinary Seaman
OS	Out of Stock
OSB	Order of St. Benedict
OSC	Orbital Sciences Corporation [Space]
OSCAR	Orbiting Satelite Carry Amateur Radio (1st launched 12 Dec 1961)
OSCAR	Orbiting Satellite Carry Amateur Radio (1st launched 12 Dec 1961)
OSCAR	Orbiting Satellite Carrying Amateur Radio [Space]
OSCRL	Operating System Command Response Language
OSD	Office of the Secretary of Defense
OSDIT	Office of Software Development and Information Technology
OSF	Open Software Foundation
OSF	Open Systems Foundation
OSF	Order of St. Francis
OSHA	Occupational Safety and Health Administration [US Government]
OSI	Office of Scientific Integrity [NIH]
OSI	Open Systems Interconnection (per ISO; 7 layer model)
OSI/RM	Open Systems Interconnection/Reference Model
OSME	Open Systems Message Exchange
OSP	Optical Storage Processor
OSPFIGP Open Shortest-Path First Internal Gateway Protocol [Internet]
OSS	Office of Strategic Services (later CIA)
OSS	Office Support System
OSS	Operation Support System [Telephony, AT&T]
OSSA	Office of Space Science and Applications [Space]
OSSE	Oriented Scintillation Spectrometer Experiment (on GRO) [Space]
OSTP	Office of Science and Technology Policy
OSTP	(White House) Office of Science and Technology Policy [US Government]
OT	Old Testament
OT	OverTime
OTA	Office of Technical Assistance
OTA	Office of Technology Assessment
OTA	Optical Telescope Assembly (on HST) [Space]
OTB	Off-Track Betting
OTC	Over The Counter (stocks)
OTF	Open Token Foundation
OTH-B	Over The Horizon - Backscatter (as in radar)
OT&LF	Open Taxi & Limousine Foundation
OTR	On The Rag
OTS	Officers' Training School
OTV	Orbital Transfer Vehicle [Space]
OUTWATS OUTward Wide Area Telephone Service [Telephony]
OV	Orbital Vehicle [Space]
OV	Orbiter Vehicle [Space]
PA	Pennsylvania
PA	Per Annum
PA	Play Aid
PA	Power of Attorney
PA	Press Agent
PA	Private Account
PA	Public Address
PA	Purchasing Agent
PABX	Private Automatic Branch eXchange [Telephony]
PACCOM	Pacific Computer Communications network consortium [Networking]
PACX	Private Automatic Computer eXchange
PAD	Packet Assembler-Disassembler [Networking]
PAH	Polycyclic Aromatic Hydrocarbon
PAL	Phase Alternation Line-rate
PAL	Programmable Array Logic
PAM	Payload Assist Module [Space]
PAM	Pulse Amplification Modulation
PARC	Palo Alto Research Center, xerox
PASS	Personal Access Satellite System [NASA]
PATROL	Program for Administrative Traffic Reports On Line
PBM	Play By Mail game
PBS	Public Broadcasting System
PBX	Private Branch eXchange [Telephony]
PC	Peace Corps
PC	PerCent; PerCentage
PC	Personal Computer (IBM wants you to believe a specific kind)
PC	Player Character (see NPC) [Role-playing]
PC	Post Card
PC	Post Cibum (after meals)
PC	Privileged Character
PC	Privy Council
PC	Program Counter
PC	Progressive Conservative party [Canada]
PC	Providence College
PC/AT	Personal Computer/Advanced Technology
PCB	PolyChlorinated Biphenyl
PCB	Printed Circuit Board
PC-DOS	Personal Computer DOS
PCI	Panel Call Indicator
PCIE	President's Council on Integrity and Efficiency
PCL	Printer Command Language
PCM	Plug-Compatible Mainframe
PCM	Pulse Code Modulation
PCPC	Personal Computers Peripheral Corporation
PCS	Permanent Change of Station
PCTE	Portable Common Tools Environment
PCTS	Posix Conformance Test Suite
PD	Per Diem
PD	Police Department
PD	Potential Difference
PD	Public Domain
PDAD	Proposed Draft ADdendum
PDE	Partial Differential Equation
PDES	Product Data Exchange Specifications
PDF	Program Development Facility
PDL	Page Description Language
PDL	Program Design Language
PDN	Public Data Network
PDP	Plasma Display Panel
PDP	Programmed Data Processor
PDP	Programmed Data Processor [DEC]
PDQ	Pretty Damned Quick
PDS	Premises Distribution System [AT&T]
PDT	Pacific Daylight Time
PE	Phase Encoded
PE	Physical Education
PE	Prince Edward island
PE	Printer's Error
PE	Professional Engineer
PE	Protestant Episcopal
PEI	Prince Edward Island
PEP	Productivity Enhancement Project
PEPE	Pepe Est Presque Emacs
PERL	Pathologically Eclectic Rubbish Lister
PERL	Practical Extraction and Report Language
PEX	Phigs/phigs+ Extension to X
PFC	Plasma Fusion Center [MIT]
PG	Parental Guidance (suggested) [Movie rating]
PGA	Professional Graphics Adapter
PGA	Pure Grain Alcohol
PHA	Pulse Height Analyzer (or Analysis)
PHIGS	Programmers Hierarchical Interactive Graphics System
PHS	Public Health Service
PhysRev Physical Review Journal	  - Phys Rev
PI	Principal Investigator
PI	Priority Interrupt
PI	Private Investigator
PIC	Plastic/Polyethelene Insulated Cable [Telephony]
PIC	Position Independant Code
PIF	Paid In Full
PIT	Principal, Interest, and Taxes
PIXEL	PIcture ELement
PLA	Programmable Logic Array
PLATO	Programmed Learning for Automated Teaching Operations (U. Ill., early '70s)
PLC	Programmable Logic Controller
PLCC	Plastic Leaded Chip Carrier
PLL	Phase-Locked Loop
PLM	Programming Language for Microcomputers
PLO	Palestine (sic?) Liberation Organization (?)
PLO	Please Leave On
PLSS	Portable Life Support System [Space]
PM	PayMaster
PM	Police Magistrate
PM	Post Meridiem
PM	Post Meridiem (after noon)
PM	PostMaster
PM	PostMortem
PM	Pressurized Module [Space]
PM	Preventive Maintenance
PM	Prime Minister
PM	Provost Marshal
PMC	Permanently Manned Capability [Space]
PMIRR	Pressure Modulated InfraRed Radiometer (on Mars Observer) [Space]
PMO	Prime Minister's Office
PMOS	P channel Metal Oxide Semiconductor (P-MOS) (see MOS)
PMS	PreMenstrual Syndrome
PMT	PhotoMultiplier Tube
PM/X	Presentation Manager for X windows
PN	Promissory Note
PNP	Positive-Negative-Positive (transistor)
PO	Petty Officer
PO	Post Office
PO	Postal Order
PO	Purchase Order
POC	Port Of Call
POD	Pay On Delivery
POE	Port Of Embarkation
POE	Port Of Entry
POGO	Polar Orbiting Geophysical Observatory
POM	Phase Of Moon
POP	Point of Presence [Telephony]
POP	Post Office Protocol [Networking] (esp. TCP/IP)
POPS	Paperless Order Processing System
POR	Price On Request
POS	Point Of Sale
POS	Professional Operating System [DEC]
POSI	Promoting conference for OSI
POSIX	Portable Operating System for unIX
POSIX	Portable Operating System Interface
POTS	Plain Old Telephone Service [Telephony]
POTV	Personnel Orbit Transfer Vehicle [Space]
POV	Point Of View
POW	Prisoner Of War
PP	Parcel Post
PP	Past Participle
PP	Post Pay (payphone) [Telephony]
PP	Primary Point
PPB	Parts Per Billion
PPC	Pour Prendre Conge' (to take leave)
PPCS	Person to Person, Collect, Special [Telephony]
PPM	Parts Per Million
PPN	Parameterized Post-Newtonian formalism for general relativity
PPN	Project Programmer Number
PPP	Point-to-Point Protocol (successor to SLIP (q.v.))
pps	Packets per Second
PPS	PostPostScriptum
PPT	Parts Per Trillion
PPT	Pulse Pair Timing
PPT	Punched Paper Tape
PQ	Province of Quebec
PR	PayRoll
PR	Public Relations
PR	Puerto Rico
PRC	Planning Research Corporation
PREPnet Pennsylvania Research & Economic Partnership Network
PRI	Primary Rate Interface (ISDN) [Telephony]
PRN	pro re nata [Medicine] (as needed?)
PROFS	PRofessional OFfice System [IBM]
PROM	Programmable Read-Only Memory
PS	PicoSecond
PS	PostScript
PS	PostScriptum
PS	Power Steering
PS	Power Supply
PS	Proposed Standard
PS	Public School
PSA	Problem Statement Analyzer
PSC	Pittsburgh Supercomputer Center
PSC	Polar Stratospheric Clouds
PSDN	Public Switched Data Network [Telephony]
PSDS	Public Switched Digital Service [Telephony, AT&T]
PSE	Programming Support Environment
PSF	Point Spread Function [Space]
PSG	Platoon SerGeant
PSI	Performance Systems International [Corporate name, Networking]
PSI	Power Systems, Incorporated [Corporate name, Model Railroading]
PSK	Phase Shift Keying
PSL	Problem Statement Language
PSN	Packet Switch Node [ARPANET/MILNET] (replaced IMP)
PSR	Product Specific Realizations
PSR	PulSaR [Space]
PSS	(unknown to me, but something in the UK environment)
PST	Pacific Standard Time
PSTN	Public Switched Telephone Network
PT	Pacific Time
PT	Patrol Torpedo (as in PT boat)
PT	Physical Therapy
PT	Physical Training
PTA	Parent-Teacher Association
PTD	Parallel Transfer Disk
PTL	Praise The Lord (ministry)
PTN	Plant Test Number [Telephony] (actual number assigned for 800 service)
PTO	Patent and Trademark Office
PTO	Please Turn Over
PTO	Power Take-Off
PTT	Post, Telephone and Telegraph administration
PTV	Passenger Transport Vehicle [Space]
PUC	Public Utilities Commision
PV	Photovoltaic [Space]
PVC	Permanent Virtual Circuit (see also VC)
PVC	Poly-Vinyl Chloride
PVO	Pioneer Venus Orbiter [Space]
PW	Prisoner of War (usually POW)
PWG	Permanent Working Group
PX	Post eXchange (see BX)
QAM	Quadrature Amplitude Modulation
QC	Quality Control
QC	Queen's Counsel (KC when queen reigning)
QD	Quaque Die (daily) [Medicine]
QDA	Quantity Discount Agreement
QED	Quod Erat Demonstrandum (which was to be demonstrated) [Latin]
QEF	Quod Erat Faciendum (which was to be done) [Latin]
QEI	Quod Erat Inveniendum (which was to be found out) [Latin]
QET	Quantum Effect Transistor
QIC	Quarter-Inch Cartridge
QID	Quater In Die (four times a day) [Medicine]
QLI	Query Language Interpreter
QM	QuarterMaster
QMC	QuarterMaster Corps
QMF	Query Management Facility
QMG	QuarterMaster General
QMS	Quality Micro Systems [Corporate name]
QNS	Quantity Not Sufficient
QSO	Quasi-Stellar Object [Space]
q.v.	???? (Latin(?): which see)
QWERTY	first six keys from left on top alphabetic row of standard keyboard
R	Restricted [Movie rating]
R	Rolemaster
RA	Regular Army
RA	Research Assistant
RA	Royal Academy
RAAF	Royal Australian Air Force
RACE	Random Access Card Equipment
RACEP	Random Access and Correlation for Extended Performance 
RAD	Radiation Absorbed Dose
RAD	Rapid Access Disk
RADAR	RAdio Detection And Ranging
RADM	Rear ADMiral
RAF	Royal Air Force
RAM	Random Access Memory (R/W)
RAM	Red Academicia de Mexico (Mexican Academic Network)
RARDE	Royal Armaments Research and Development Establishment
RARE	R\'eseaux Associ\'es pour la Recherche Europ\'eenne (the European Organization of Research Networks)
RAS	Reliability, Availability, and Serviceability
RASC	Residence Account Service Center
RATS	Radio Amateur Telecommunications Society
R&B	Rhythm and Blues (commonly R and B)
RBC	Red Blood Count
RBI	Runs Batted In
RBOC	Regional Bell Operating Company
RC	Red Cross
RC	Regional Center
RC	Resistor-Capacitor circuit (as in filters)
RC	Roman Catholic
RCA	Radio Corporation of America [Corporate name]
RCAF	Royal Canadian Air Force
RCAS	Reserve Component Automation System
RCC	Radio Common Carrier
RCMP	Royal Canadian Mounted Police
RCS	Reaction Control System [Space]
R&D	Research and Development (commonly R and D)
RD	Rural Delivery
RDA	Remote Data Access
RDBMS	Relational DataBase Management System
RDF	Radio Direction Finding
REA	Rail Express Agency
RECON	Reconnaissance
REM	Rapid Eye Movement
REO	R. E. Olds
REO	Removable, Erasable, Optical
RETMA	Radio {something(equipment?)?} {something?} Manufacturers' Association (????)
REXX	Restructured EXtended eXecutor
RF	Radio Frequency
RF	Radio Frequency [Space]
RFC	Request For Comments (ala ARPA Internet)
RFD	Rehoboth (MA) Fire Department
RFD	Rural Free Delivery
RFI	Radio Frequency Interference
RFI	Radio Frequency Interference [Space]
RFP	Request for Proposal
RFQ	Request for Quote
RFS	Remote File System
RGB	Red Green Blue
RGP	Raster Graphics Processor
RH	Right Hand
RHC	Regional (Bell) Holding Company
RHS	Right Hand Side
RI	Rhode Island
RIACS	Research Institute for Advanced Computer Science (NASA)
RIACS	Research Institute for Advanced Computer Science [Space]
RIAS	Radio In the American Sector, berlin
RIF	Reading Is Fundamental
RIF	Reduction In Force
RILM	Repertoire International de Literature Musicale
RIP	Rest In Peace (or Requiescat In Pace : latin)
RIP	Routing Interchange Protocol
RIPE	R\'eseaux IP Europ\'eenne (European IP Networks) (of RARE, q.v.)
RISC	Reduced Instruction Set Computer
RITA	Recognition of Information Technology Achievement award
RJE	Remote Job Entry
RLC	Resistor Inductor Capacitor
RLG	Research Libraries Group
RLIN	Research Libraries Information Network (run by RLG (q.v.))
RLL	Run Length Limited
RMA	Radio Manufacturers' Association
RMA	Return Materials Authorization
RMATS	Remote Maintenance Administration and Traffic System [Telephony]
RMS	Remote Manipulator System [Space]
RMS	Richard M. Stallman
RMS	Root Mean Square
RMS	Royal Mail Ship
RN	Registered Nurse
RN	Royal Navy
RNA	RiboNucleic Acid
RNGC	Revised New General Catalog [Space]
RNZAF	Royal New Zealand Air Force
ROFF	Run-OFF
ROG	Receipt Of Goods
ROM	Range Of Motion [Medicine]
ROM	Read-Only Memory
ROM	Rupture Of Membrane (as in birth)
ROSAT	ROentgen SATellite [Space]
ROSE	RATS (q.v.) Open Systems Environment
ROSE	Remote Operations Service Entity (per ISO/CCITT layer 7)
ROTC	Reserve Officers' Training Corps
ROTS	Rotary Out Trunks Selectors
ROYGBIV Red, Orange, Yellow, Green, Blue, Indigo, Violet
RPC	Remote Procedure Call
RPG	RePort Generator
RPG	Role Playing Game
RPI	Rensselaer Polytechnic Institute
RPM	Revolutions Per Minute
RPN	Reverse Polish Notation
RPO	Railway Post Office
RPS	Revolutions Per Second
RPV	Remotely Piloted Vehicle
RQ	RuneQuest
RR	RailRoad
RR	Route Relay
RR	Rural Route
RRO	Rate and Route Operator [Telephony]
RS	Recommended Standard (EIA)
RS	Recording Secretary
RS	Revised Status
RS	Right Side
RS	Royal Society
RSCS	Remote Spooling Communications Subsystem
RSFSR	Russian Soviet Federated Socialist Republic
RSN	Real Soon Now
RSU	Remote Switching Unit
RSV	Revised Standard Edition
RSVP	Repondez S'il Vous Plait (please reply)
RSWC	Right Side up With Care
RT	RadioTelephone
RT	RealTime
RTA	Remote Trunk Arrangement [Telephony]
RTAC	Regional Technical Assistance Center [Telephony]
RTF	Rich Text Format
RTFM	Read The @!# Manual
RTFM	Read The F***ing Manual
RTG	Radioisotope Thermoelectric Generator
RTG	Radioisotope Thermoelectric Generator [Space]
RTLS	Return To Launch Site (Shuttle abort mode) [NASA, Shuttle, Space]
RTR	Ready to Run [Model Railroading]
RTR	Reel-To-Reel
RTS	Request To Send (EIA RS-232-C)
RTTY	Radio Teletype
RU	Receive Unit
RVD	Remote Virtual Disk [MIT]
RW	Right Worshipful
RW	Right Worthy
RX	Receive
Ry	Railway
S	South
S	Supplement
SA	Salvation Army
SA	Seaman Apprentice
SA	Service Assistant
SA	Sex Appeal
SA	Sine Anno (without date)
SA	South Africa
SA	South America
SA	Subject to Approval
SAA	South Atlantic Anomaly
SAA	South Atlantic Anomaly [Space]
SAA	Systems Application Architecture
SAC	Special Area Code [Telephony] (represent services, not places)
SAC	Strategic Air Command (see TAC)
SAC	Strategic Air Command [US military]
SADD	Students Against Drunk Driving
SAFENET Survivable Adaptable Fiberoptic Embedded Network [US Navy]
SAM	Surface to Air Missile
SAM	Surface-to-Air Missile
SAMA	Step-by-step Automatic Message Accounting [Telephony]
SAMPEX	Solar Anomalous and Magnetospheric Particle EXplorer [Space]
SAMTO	Space And Missile Test Organization [Space]
SAO	Smithsonian Astrophysical Observatory [Space]
SAP	Second Audio Program
SAP	Service Access Point [OSI, Networking]
SAR	Search And Rescue
SAR	Synthetic Aperture Radar
SARA	Satellite pour Astronomie Radio Amateur [Space]
SARA	Stichting Academisch Rekencentrum Amsterdam (Amsterdam Universities Computing Center)
SAREX	Search and Rescue Exercise [Space]
SAREX	Shuttle Amateur Radio Experiment [Space]
SARTS	Switched Access Remote Test System
SAS	Small Astronomy Satellite
SAS	Space Activity Suit [Space]
SASE	Self-Addressed Stamped Envelope
SASI	Shugart Associates Systems Interface
SAT	Satellite [Space]
SAW	Surface Acoustic Wave
SBA	Small Business Administration
SC	Secondary Channel
SC	Sectional Center
S&C	Skull & Crossbones
SC	South Carolina
S/C	SpaceCraft [Space]
SC	SubCommittee
SCA	Shuttle Carrier Aircraft [Space]
SCAD	Subsonic Cruise Armed Decoy
SCADC	Standard Central Air Data Computer
SCAME	SCreen oriented Anti-Misery Editor
SCAMP	Single-Chip A-series Mainframe Processor
SCAN	Switched Circuit Automatic Network
SCC	Specialized Common Carriers
SCC	Switching Control Center
SCCS	Source Code Control System
SCE	Signal Conversion Equipment
SCE	Structure Chart Editor
SCI	SpaceCraft Incorporated
SCIFI	SCIence FIction (often used pejoratively of what really isn't)
SCO	Santa Cruz Operation
SCOOPS	SCheme Object Oriented Programming System
SCOTS	Surveilance and Control Of Transmission Systems
SCSI	Small Computer Systems Interface
SCT	Schmidt-Cassegrain Telescope [Space]
SCUBA	Self Contained Underwater Breathing Apparatus
SCUD	Subsonic Cruise Unarmed Decoy
SD	South Dakota
SDB	Source(?) DeBugger
SDI	Standard Disk Interconnect [DEC]
SDI	Strategic Defense Initiative [Space, US Government]
SDIO	Strategic Defense Initiative Organization [Space, US Government]
SDLC	Synchronous Data Link Control [IBM]
SDM	Sub-rate Data Multiplexer
SDN	Software Defined Network [Telephony, AT&T]
SDN	System Development Network (Korea)
SDO	Staff Duty Officer 
SDSC	San Diego Supercomputer Center
SDV	Shuttle Derived Vehicle [Space]
SE	Service Engineer (see also CE, FE)
SE	South East
SEATO	SouthEast Asia Treaty Organization
SEC	Security Exchange Commission
SECNAV	SECretary of the NAVy
SED	Stream EDitor
SEI	Software Engineering Institute (Carnegie Mellon)
SEI	Space Exploration Initiative [Space]
SEL	Software Engineering Laboratory
SEM	Scanning Electron Microscope
SEST	Swedish-European Submillimeter Telescope [Space]
SETI	Search for Extra Terrestrial Intelligence [Space]
SETI	Search for ExtraTerrestrial Intelligence [Space]
SF	San Francisco
SF	Science Fiction; Speculative Fiction
SF	Standard Form
SF	Star Frontiers
SFRPG	Science Fiction Role Playing Game
SG	StarGuard
SG	SubGroup
SGML	Standard Generalized Markup Language
SHAPE	Supreme Headquarters Allied Powers Europe
SHAR	SHell ARchiver
SHCD	Sherlock Holmes Consulting Detective
SHF	Super High Frequency (3-30GHz)
SHRPG	Super Hero Role Playing Game
SI	Staten Island
SIAM	Society for Industrial and Applied Mathematics
SID	Sudden Ionospheric Disturbance [Space]
SIG	Special Interest Group
SIGCAT	Special Interest Group for Cd-rom Applications Technology
SIMD	Single Instruction, Multiple Data
SIMM	Single In-line Memory Module
SIMM	System Integrated Memory Module
SINE	SINE is not EINE
SIPS	Satellite Imagery Processing System
SIR	Shuttle Imaging Radar [Space]
SIRTF	Space (formerly Shuttle) InfraRed Telescope Facility [Space]
SIRTF	Space Infrared Telescope Facility [Space]
SIS	Strategic Information System
SISCOM	Satellite Information System COMpany
SITA	Societe Internationale Telecommunications Aeronautiques
SJ	Society of Jesus
Skyhook Surface to space "elevator" transportation system [Space]
SL	Salvage Loss
SL	Space Launch [Space]
SL	SpaceLab [Space]
SLA	Special Libraries Association
SLA	Synchronous Line Adapter
SLAC	Stanford Linear Accelerator Center
SLAN	Sine Loco, Anno, (vel) Nomine (without place, year, or name)
SLAR	Side Looking Airborne Radar
SLAR	Side-Looking Airborne Radar [Space]
SLBM	Submarine Launched Ballistic Missiles
SLC	Space Launch Complex [Space]
SLC	Subscriber Loop Carrier [Telephony]
SLDC	Synchronous Data Link Control
SLIP	Serial Line Internet Protocol
SLIP	Serial Line IP (sometimes SL/IP) (see also PPP)
SLP	Super Long Play (VHS VCR)
SLS	Space(lab) Life Sciences [Space]
SM	Service Mark
SMA	Sergeant Major of the Army
SMA	Spectrum Manufacturers Association
SMC	Small Magellanic Cloud (see LMC)
SMC	Small Magellanic Cloud [Space]
SMD	Storage Module Device (interface standard for disk drives)
SMD	Surface Mounted Devices
SMDR	Station Message Detail Recording [Telephony]
SMDS	Switched Multi-megabit Data Service [Telephony, Networking]
SME	Solar Mesosphere Explorer [Space]
SMEGMA	Sophisticated Modern Editor with Gloriously Magnificent Abilities
SMERSH	Abbr. of Russian phrase meaning "Death to the spies."
SMEX	SMall EXplorers [Space]
SMILS	Sonobuoy Missile Impact Location System
SMM	Solar Maximum Mission (satellite 1980-1989) [Space]
SMTP	Simple Mail Transfer Protocol
SMU	Southeastern Massachusetts University
SMU	Southern Methodist University
SN	Science News [Periodical]
SN	Serial Number
SN	Super Nova
SN	SuperNova (e.g., SN1987A) [Space]
SNA	Systems Network Architecture [IBM]
SNADS	SNA Distribution Services
SNAFU	Situation Normal -- All Fouled Up (also more profane versions)
SNAP	Shipboard Non-tactical Automated data Processing program
SNAP	Sub Network Access Protocol [OSI, Networking]
SNCF	Societe National des Chemins de Fer (French National Railways)
SNF	Server-Natural Format
SNMP	Simple Network Management Protocol [TCP/IP]
SNOBOL	StriNg Oriented symbOLic Language
SNPA	SubNetwork Point of Attachment
SNR	Signal to Noise Ratio
SNR	Signal to Noise Ratio [Space]
SNR	SuperNova Remnant [Space]
SNU	Solar Neutrino Units [Space]
SO	Seller's Option
SO	Significant Other
SO	Space Opera
SO	Strike Out
SOAP	Symbolic Optimizing Assembler Program
SOFIA	Stratospheric Observatory For Infrared Astronomy [Space]
SOH	Start Of Header, ASCII control character (dec=01,control-A)
SOHIO	Standard Oil of oHIO [Corporate name]
SOHO	SOlar Heliospheric Observatory [Space]
SOL	Short on Landing (or, colloquially, Shit Out of Luck)
SONAR	SOund Detection And Ranging
SONET	Synchronous Optical Network [Telephony]
SOP	Standard Operating Procedure
SOS	Save Our Souls (International standard distress call, Morse ...---...)
SOS	Silicon On Sapphire
SOS	Son of Stopgap (editor) [DEC]
SP	Shore Patrol
SP	Short Play (VHS VCR)
s.p.	sine prole (Latin: without issue) [Genealogy]
SP	Southern Pacific [Corporate name, Railroading]
SP	Stack Pointer
SP	Star Patrol
SPA	Software Publishers Association
SPAG	Standards Promotion and Applications Group
SPAN	Space Physics and Analysis Network [NASA] (DECnet)
SPAN	Space Physics and Analysis Network [Space]
SPAR	Stock Points Adp Replacement
SPARC	Scalable Processor ARChitecture
SPARC	Standards, Planning, And Requirements Committee
SPAWAR	naval SPAce and WARfare command
SPC	Software Productivity Consortium
SPCA	Society for the Prevention of Cruelty to Animals
SPCC	Society for the Prevention of Cruelty to Children
SPDM	Special Purpose Dextrous Manipulator [Space]
SPEC	Systems Performance Evaluation Cooperative
SPITBOL SPeedy ImplemenTation of snoBOL
SPNI	Society for the Protection of Nature in Israel
SPOT	Systeme Probatoire pour l'Observation de la Terre [Space]
SPS	Solar Power Satellite [Space]
SPUR	Systech Pluraxial Unplug Repeater
SQE	Signal Quality Error (IEEE 802.3, eqv to D/I/X "Collision Presence Test") [Ethernet]
SQIID	Simultaneous Quad Infrared Imaging Device (at NOAO)
SQL	Structured Query Language
SQUID	Superconducting QUantum Interference Device
SRAM	Short Range Attack Missile
SRAM	Static RAM
SRB	Solid (fuel) Rocket Booster [Space]
SRG	Short and Ring Ground (test) [Telephony]
SRI	Stanford Research Institute
SRM	Solid Rocket Motor [Space]
SRO	Standing Room Only
SS7	Signalling System #7 [Telephony]
SSA	Social Security Administration [US Government]
SSB	Single Side Band
SSC	Superconducting Super Collider
SSE	South-SouthEast
SSF	Space Station Fred (er, Freedom) [Space]
SSF	Space Station Freedom [NASA, Space]
SSFF	Showcase Software Factory of the Future
SSG	Staff SerGeant
SSI	Small Scale Integration
SSI	Solid-State Imager (on Galileo) [Space]
SSI	Space Services Incorporated [Corporate name, Space]
SSI	Space Studies Institute [Space]
SSI	Supplemental Security Income
SSME	Space Shuttle Main Engine [Space]
SSPF	Space Station Processing Facility [Space]
SSPS	Satellite Solar Power Station [Space]
SSR	Secondary Surveillance Radar
SSR	Soviet Socialist Republic
SSRMS	Space Station Remote Manipulator System [Space]
SST	Spectroscopic Survey Telescope [Space]
SST	SuperSonic Transport [Space]
SSTO	Single Stage To Orbit [Space]
SSTV	Slow Scan TeleVision
SSW	South-SouthWest
ST	Short Ton
STARS	Software Technology for Adaptable, Reliable Systems
STD	Sacrae Theologiae Doctor (doctor of sacred theology)
STD	Sexually Transmitted Disease (replaces VD)
STD	State Transition Diagram
STD	Subscriber Trunk Dialing (British, and elsewhere; equiv. DDD in USA)
STI	Standard Tape Interconnect [DEC]
STILO	Scientific and Technical Intelligence Liaison Office
STIS	Space Telescope Imaging Spectrometer (to replace FOC and GHRS) [Space]
STL	St. Louis (airport designation)
STN	SuperTwisted Nematic
STOL	Short TakeOff and Landing
STP	Shielded Twisted Pair [Telecom, Networking]
STP	Software Through Pictures
STP	Standard Temperature and Pressure (see NTP)
STRPG	Star Trek:  The Role-Playing Game
STS	Space Transportation System (space shuttle) [NASA]
STScI	Space Telescope Science Institute [Space]
STV	Single Transferable Vote
STV	Space Transfer Vehicle [Space]
SUM	Symantec Utilities for Macintosh
SUN	Stanford University Network
SUN	SUN MicroSystems Computer (not an Acronym) [Corporate name]
SUNOCO	SUN Oil COmpany [Corporate name]
SUNY	State University of New York
SURAnet Southeastern Universities Research Association Network
SVID	System V Interface Definition
SW	South West
SW	SuperWorld
SWAS	Submillimeter Wave Astronomy Satellite [Space]
SWBT	South Western Bell Telephone [Telephony]
SWF	ShortWave Fading [Space]
SWIFT	Society for Worldwide Interbank Financial Communications
SWS	Scientific Workstation Support
SXS	Step by Step switching [Telephony]
T	Traveler
T1	1.544Mbps [Telephony], one of the basic signalling systems 24x64Kb
T3	45Mbps (eq 28 T1 channels) [Telephony]
TA	Teaching Assistant
TAC	Tactical Air Command (see SAC)
TAC	Terminal Access Controller [ARPANET/MILNET] (replaced TIP)
TACACS	Terminal Access Controller Access Control System [ARPANET/MILNET]
TACCS	Tactical Army Combat service support Computer System
TAE	Transportable Applications Environment
TAL	Trans-Atlantic Abort Landing [NASA, Shuttle]
TAL	Transatlantic Abort Landing (Shuttle abort plan) [Space]
TANSTAAFL	There Ain't No Such Thing As A Free Lunch
TAR	Tape ARchiver
TASI	Time Assign{ment,ed} Speech Interpolation [Telephony]
TAU	Thousand Astronomical Units [Space]
TB	TuBerculosis
TBA	To Be Announced
TBD	To Be Determined
TBD	To Be Done
TC	Teachers College
TCA	Terminal Controlled Airspace
TCP	Transmission Control Protocol
TCP/IP	Transmission Control Protocol/Internet Protocol
TCS	Thermal Control System [Space]
TCSEC	Trusted Computer System Evaluation Criteria (orange book)
TCT	To Challenge Tomorrow
TD	Tardive Dyskinesia
TD	TouchDown
TD	Treasury Department
TDCC	Transportation Data Coordinating Committee
TDE	Transition Diagram Editor
TDI	Trusted Database Interpretation
TDM	Time-Division Multiplexer
TDR	Time Domain Reflectometer
TDRS	Tracking and Data Relay Satellite [Space]
TDRSS	Tracking and Data Relay Satellite System [Space]
TDY	Temporary DutY
TECO	Tape Editor and COrrector
TECO	Text Editor and COrrector
TEFLON	polyTEtraFLuOrethyleNe
TES	Thermal Emission Spectrometer (on Mars Observer) [Space]
TFP	Tops Filing Protocol
TFS	Translucent File System
TFT	The Fantasy Trip
TFT	Thin Film Transistor
TG	Thieves' Guild
TGV	Tres Grande Vitesse (French, Very High Speed) [Railroading]
TGV	Two Guys and a VAX (humorous variant) [Corporate name]
THIEF	THief Isn't Even Fine
THIEF	This Here Isn't Even Fine
THOR	Tandy High-intensity Optical Recording
TI	Texas Instruments
TIA	Thanks In Advance [Net jargon]
TIA	Transient Ischemic Attack
TIC	TermInfo Compiler
TID	Ter In Die (three times a day)
TID	Transaction ID
TIFF	Tag Image File Format
TIP	Terminal Interface Processor [ARPANET/MILNET] (replaced by TAC)
TIS	Trusted Information Systems [Corporate name]
TISN	Tokyo International Science Network (Japan)
TKO	Technical Knock Out [Boxing]
TL	Total Loss
TLA	Three Letter Acronym
TLC	Tender Loving Care
TLI	Transort-Level Interface
TM	TradeMark
TMA	Tycho Magnetic Anomaly (movie 2001)
TMAC	Treasury department's Multiuser Acquisition Contract
TMIS	Telecommunications Management Information System
TMO	Telephone Money Order
TMP	The Morrow Project
TMRC	Tech Model Railroad Club [MIT]
TMRC	Transportation Modeling Research Center (TMRC {above} alter ego)
TN	Tennessee
TN	Twisted Nematic
TNC	Threaded Neill Concelman (connector) [Electronics] (see also BNC)
TNF	Tumor Necrosis Factor [Biology, Medicine]
TNP	Tech Nickel Plate (RR) [TMRC]
TNT	TriNitro Toluene
TO	Telegraph Office
TO	Turn Over
TODS	Transactions on Database Systems (ACM)
TOMS	Total Ozone Mapping Spectrometer [Space]
TOMS	Transactions on Mathematical Software (ACM)
TOOIS	Transactions on Office Information Systems (ACM)
TOP	Technical Office Protocol
TOPLAS	Transactions on Programming Languages and Systems (ACM)
TOPS	Traffic Operator Position System [Telephony]
TOPSMP	Traffic Operator Position System Multipurpose [Telephony]
TORES	Text ORiented Editing System
TOS	Transfer Orbit Stage [Space]
TOW	Tube launched, Optically tracked, and Wire guided
TOY	Time Of Year (clock)
TP	Transaction Processing
TP	Transport Protocol (ISO/CCITT Transport Services (TP0-TP4); like TCP)
TP4	Transport Protocol, class 4 [ISO]
TPC	The Phone Company (from classic movie: _The President's Analyst_)
TPI	Tracks Per Inch
TPO	Traveling Post Office
TPP	TetraarylPorPhyrin
TPS	Technical Publishing Software
TPS	TeleProcessing Services
TPS	Thermal Protection System [Space]
TR	Tech Report (at least at LCS (q.v.), maybe others)
TR	Technical Reference [Bell, Telephony]
TRG	Tip and Ring Ground (test) [Telephony]
TROFF	Text RunOFF, text formatter
TRUSIX	TRUSted unIX
TRW	Thompson, Ramo, and Woolridge
TS	Top Secret
TSAP	Transport Service Access Point [OSI, Networking]
TSD	Total System Design
TSP	Teleprocessing Services Program
TSP	Thrift Savings Plan
TSP	Time Synchronization Protocol
TSP	TriSodium Phosphate
TSR	TSR (Fortune 500 Company that manufactures Dungeons & Dragons)
TSS	Tethered Satellite System [Space]
TSTO	Two Stage to Orbit [Space]
T&T	Tunnels & Trolls
TTFN	Tah Tah, For Now
TTL	Transistor Transistor Logic
TTMA	Tennessee Tech Microcomputer Association
TTU	Tennessee Technological University
TTY	TeleTYpe
TUNIS	Toronto UNIversity System
TV	TeleVision
TVA	Tennessee Valley Authority
TW	Thieves' World
TWA	Trans World Airlines [Corporate name]
TWB	Terrestrial WideBand [Networking, DARPA]
TWIMC	To Whom It May Concern
TWT	Traveling Wave Tube
TWX	TeletypeWriter eXchange
TX	Texas
Tx	Transmit
u	(representing the greek mu) - micro
U	Universe
UA	United Artists
UAR	United Arab Republic
UAR	User Action Routine
UARS	Upper Atmosphere Research Satellite [Space]
UART	Universal Asynchronous Receiver Transmitter
UBA	UniBus Adapter [DEC]
UBC	Universal Bibliographic Control
UBC	University of British Columbia
UBM	Unpressurized Berthing Mechanism [Space]
UCAR	University Corporation for Atmospheric Research
UCB	University of California at Berkeley
UCD	Uniform Call Distributor [Telephony]
UCD	University of California at Davis
UCI	University of California at Irvine
UCL	University College London
UCLA	University of California at Los Angeles
UCR	University of California at Riverside
UCSB	University of California at Santa Barbara
UCSC	University of California at Santa Cruz
UCSD	University of California at San Diego
UCSF	University of California at San Francisco
UDB	Unified DataBase
UDMH	Unsymmetrical DiMethyl Hydrazine [Space]
UDP	User Datagram Protocol
UEC	User Environment Component
UFO	Unidentified Flying Object [Space]
UGC	Uppsala General Catalog [Space]
UH	Upper Half
UHF	Ultra High Frequency (300-3000MHz)
UID	Unique IDentifier
UID	User IDentification [UNIX]
UIMS	User Interface Management System
UIT	Ultraviolet Imaging Telescope (Astro package) [Space]
UIUC	University of Illinois at Urbana-Champaign
UK	United Kingdom
UKST	United Kingdom Schmidt Telescope [Space]
UL	Underwriters Laboratory
ULANA	Unified Local-Area Network Architecture
UMOC	Ugliest Man On Campus [MIT]
UMT	Universal Military Training
UN	United Nations
UNESCO	United Nations Educational, Scientific, & Cultural Organization
UNICEF	United Nations International Children's Emergency Fund (now United Nat. Child. Fund)
UNICS	UNiplex Information Computer Services
UNIX	Not an acronym at all.	Was a joke on MIT's MULTICS.
UNMA	Unified Network Management Architecture [AT&T]
UNO	United Nations Organization
UP	Union Pacific [Railroading, Corporate name]
UPC	Universal Product Code
UPI	United Press International
UPI	United Press International [Corporate name]
UPS	Uninterruptible Power Supply
UPS	United Parcel Service [Corporate name]
UR	University of Rochester
URI	University of Rhode Island
US	United States (of America)
USA	Union of South Africa
USA	United States Army
USA	United States of America
USAF	United States Air Force
USAFA	United States Air Force Academy (in Colorado Springs)
USAN	University Satellite Network
USB	Upper Side Band
USC	University of Southern California
USCG	United States Coast Guard
USDA	United States Department of Agriculture
USES	United States Employment Service
USFL	United States Football League
USGS	United States Geological Survey
USIA	United States Information Agency
USM	United States Mail
USMC	United States Marine Corps
USMP	United States Microgravity Payload [Space]
USN	United States Navy
USO	United Service Organizations
USO	Unix Software Operation
USP	United States Pharmacopeia
USPS	United States Postal Service
USR	User Service Routines
USS	United States Ship
USSR	Union of Soviet Socialist Republics
USSS	User Services and Systems Support
USW	Und So Weiter
UT	Universal Time (a.k.a. GMT, UTC, or Zulu Time)
UT	University of Tennessee
UT	University of Texas
UT	UTah
UTC	Coordinated Universal Time (a.k.a. UT)
UTC	Universal Coordinated Time (a.k.a. UT)
UTnet	University of Texas Network
UTP	Unshielded Twisted Pair [Telecom, Networking]
UUCP	UNIX-to-UNIX Copy Program
UUG	Unix User Group
UV	UltraViolet
UVS	UltraViolet Spectrometer
UW	UnderWriter
UW	Univ of Wisconsin
VA	Veterans Administration
VA	Virginia
VAB	Vehicle Assembly Building (formerly Vertical Assembly Building) [Space]
VAFB	Vandenberg Air Force Base [Space]
VAN	Value Added Network (e.g. Tymnet, Telenet, etc)
VANS	Value-Added Network Services
VAR	Value Added Remarketer (reseller)
VASI	Visual Approach Slope Indicator
VAT	Value Added Tax
VAX	Virtual Address eXtended
VAXBI	VAX Bus Interconnect
VC	Viet Cong
VC	Virtual Circuit
Vcc	Voltage (Common Cathode?)
VCM	Voice Coil Motor
VCO	Voltage Controlled Oscillator
VCR	VideoCassette Recorder
VCU	Virginia Commonwealth University
VD	Venereal Disease (see also STD)
VDFM	Virtual Disk File Manager
VDI	Virtual Device Interface
VDM	Vienna Development Method
VDM	Virtual Device Metafile
VDT	Video Display Terminal
VEEGA	Venus-Earth-Earth Gravity Assist (Galileo flight path) [Space]
VF	Video Frequency
VF	Voice Frequency
VFO	Variable Frequency Oscillator
VFR	Visual Flight Rules [Aviation]
VFW	Veterans of Foreign Wars
VFW	Volunteer Fire Department
VG	Very Good
VG	Vicar-General
VGA	Video Graphics Array
Vgg	Voltage (Gate to Ground?)
V&H	Vertical and Horizontal (CO coordinate tape) [Telephony]
VHDL	Vhsic Hardware Description Language
VHF	Very High Frequency (30-300MHz)
VHS	Video Home System (VCR)
VHSIC	Very High Speed Integrated Circuit
VI	VIsual editor
VIABLE	Vertical Installation Automation BaseLinE
VILE	VI Like Emacs
VINE	Vine Is Not Emacs
VIP	Very Important Person
VISTA	Volunteers In Service To America
VITA	Vme International Trade Association
VJ	Video Jockey
VL	Vulgar Latin
VLA	Very Large Array [Space]
VLBA	Very Long Baseline Array [Space]
VLBI	Very Long Baseline Interferometry [Space]
VLF	Very Low Frequency (3-30KHz)
VLIW	Very Long Instruction Word
VLSI	Very Large Scale Integration
VLT	Very Large Telescope [Space]
VM	Virtual Memory
VM/CMS	Virtual Machine/Conversational Monitor System
VMM	Virtual Memory Manager
VMOS	Vertical Metal Oxide Semiconductor (V-MOS) (see MOS)
VMR	Vertical Market Reseller
VMS	Vertical Motion Simulator [Space]
VMS	Virtual Memory System [DEC]
VOA	Voice Of America
VOIR	Venus Orbiting Imaging Radar (superseded by VRM) [Space]
VOIS	Voice-Operated Information System
VOQ	Visiting Officer's Quarters
VPI&SU	Virginia Polytechnic Institute and State University
VRC	Vertical Redundancy Character
VRM	Venus Radar Mapper (now called Magellan) [Space]
VRM	Virtual Resource Manager
VSAT	Very Small Aperture Terminal (satellite dish)
VSX	X/open Verification Suite
VTAM	Virtual Telecommunications Access Method [IBM]
VTOC	Volume Table Of Contents
VTOL	Vertical TakeOff and Landing
VTR	VideoTape Recorder
VUP	Vax Unit of Performance
V&V	Villains & Vigilantes
VVSS	Vertical Volute Spring Suspension
W	West
W	Width
WA	Washington
WA	Western Australia
WAC	Womens Air Corps
WAIS	Wide Area Information Server
WARC	World Administrative Conference
WATS	Wide Area Telephone Service
WB	Water Ballast
WB	WayBill
WBC	White Blood Cells
WC	Water Closet
WC	Without Charge
WCTU	Women's Christian Temperance Union
WD	White Dwarf [Space]
w.d.	will dated [Genealogy]
WECo	Western Electric Company [AT&T] (manufacturing arm of AT&T)
WFPC	Wide Field / Planetary Camera (on HST) [Space]
WFPCII	Replacement for WFPC [Space]
WG	Working Group
WH	WarHammer
WHBL	World Home Bible League
WHCA	White House Communications Agency [US Government]
WHO	World Health Organization
WI	Wisconsin
WIMP	Windows/Icons/Mouse Programming(?)
WIPP	(nuclear) Waste Isolation Pilot Plant [DOE]
WIS	WWMCCS Information System
WITS	Washington Interagency Telecommunications System
WIYN	Wisconsin / Indiana / Yale / NOAO telescope [Space]
WMSCR	Weather Message Switching Center Replacement
WOM	Write Only Memory
WOP	WithOut Papers [Immigration]
WOPR	War Operations Planned Response (from "Wargames" movie)
WORM	Write Once, Read Many times
WOW	Worlds of Wonder
w.p.	will proved [Genealogy]
WP	Word Processing
WP	Working Paper
WPI	Worcester Polytechnic Institute
WSI	Wafer Scale Integration
WSMR	White Sands Missile Range [Space]
WSW	West-SouthWest
WTR	Western Test Range [Space]
WU	Washington University
WU	Western Union
WUPPE	Wisconsin Ultraviolet PhotoPolarimter Experiment (Astro package) [Space]
WV	West Virginia
WW	World War
WWI	World War I
WWII	World War II
WWMCCS	World-Wide Military Command and Control System
WY	Wyoming
WYSIWIS What You See Is What I See
WYSIWYG What You See Is What You Get
XCF	eXperimental Computing Facility
XD	without Dividend
XDR	eXternal Data Representation
XFER	Transfer
XINU	XINU Is Not UNIX
XL	eXtra Large
XMM	X-ray Multi Mirror [Space]
XMTR	transMiTteR (the X is for trans)
XNS	Xerox Network Services
XO	eXecutive Officer
XOR	eXclusive OR (logical function)
XPORT	Transport
XSECT	cross SECTion
XTAL	crysTAL (another version of x for crys, see XMTR)
XUI	X-windows User Interface
XUV	eXtreme UltraViolet [Space]
YA	Yet Another
YACC	Yet Another Compiler Compiler
YB	YearBook
YMCA	Young Mens Christian Association
YMHA	Young Mens Hebrew Association
YOB	Year Of Birth
YP	Yellow Pages
YRS	Ysgarth Rules System
YSO	Young Stellar Object [Space]
YST	Yukon Standard Time
YT	Yukon Territory
YT	Yukon Time
YTD	Year To Date
YWCA	Young Womens Christian Association
YWHA	Young Womens Hebrew Association
Z	Zenith
Z	Zero
Z	Zulu (time)
ZB	Zero Beat
ZETA	Zero Energy Thermonuclear Assembly
ZGS	Zero Gradient Synchrotron
ZI	Zonal Index
ZIF	Zero Insertion Force (connector/socket)
ZIP	Zone Improvement Plan (US post office code)
ZK	barrage balloon (navy symbol)
ZMRI	Zinc Metals Research Institute
ZPG	Zero Population Growth
ZPRSN	Zurich Provisional Relative Sunspot Number
ZST	Zone Standard Time
ZT	Zone Time
ZWEI	Zwei Was Eine Initially